EA ./textures/wall_e.xpm
NO ./textures/wall_n.xpm
WE ./textures/wall_w.xpm
SO ./textures/wall_s.xpm
S ./textures/dino.xpm

C 0,0,100
F 220,200,110
R 1900 1000

 1111111111111111111111111111111
  111111011000000000112222222001
 1111111010110000011122222222011
 100100000000000000022222222201
1111111110110000011122222222211
100000000011000001110222222221
111110110111111011100000222221111
   111110111111111011101222222221
 11100000011010101112222222220111
 100020000000000011222222222211
 10000000000000001101012222221
 110000011101010111110111222211
 11110111 1110101  10111121N201
 11111111 1111111  111111111111