EA ./textures/wall_e.xpm
NO ./textures/wall_n.xpm
WE ./textures/wall_w.xpm
SO ./textures/wall_s.xpm
S ./textures/dino.xpm

C 0,0,100
F 220,200,0
R 1800 990

11111
10001
10W01
10001
11111